愛	爱	ai4	/to love/affection/to be fond of/to like/
安	安	an1	/content/calm/still/quiet/to pacify/peace/
八	八	ba1	/eight/8/
白	白	bai2	/white/snowy/empty/blank/bright/clear/plain/pure/gratuitous/
報	报	bao4	/to announce/to inform/report/newspaper/recompense/revenge/
比	比	bi3	/(particle used for comparison and "-er than")/to compare/to contrast/to gesture (with hands)/ratio/
邊	边	bian1	/side/edge/margin/border/boundary/
表	表	biao3	/surface/exterior/to watch/to show/express/an example/a list or table/a meter/a watch/chart/external/
別	别	bie2	/leave/depart/separate/distinguish/classify/other/another/do not/must not/to pin/
纔	才	cai2	/just/not until/
常	常	chang2	/always/ever/often/frequently/common/general/constant/
場	场	chang3	/a courtyard/open space/place/field/a measure word/(a measure word, used for sport or recreation)/
車	车	che1	/car/a vehicle/machine/to shape with a lathe/
處	处	chu3	/to reside/to live/to dwell/to be in/to stay/get along with/to be in a position of/deal with/
度	度	du4	/capacity/degree/standard/
反	反	fan3	/wrong side out or up/anti-/
放	放	fang4	/to release/to free/to let go/to put/to place/to let out/
風	风	feng1	/wind/news/style/custom/manner/
服	服	fu2	/clothes/dress/garment/submit/take (medicine)/
干	干	gan1	/dry/to concern/shield/
感	感	gan3	/to feel/to move/to touch/to affect/
各	各	ge4	/each/every/
更	更	geng4	/more/even more/further/still/still more/
共	共	gong4	/all together/in while/to share/common/general/together/
光	光	guang1	/light/ray/bright/
果	果	guo3	/fruit/result/
何	何	he2	/carry/what/how/why/which/
合	合	he2	/Chinese musical note/fit/to join/
華	华	hua2	/(abbreviation for) China/(surname) Hua/magnificent/splendid/flowery/
活	活	huo2	/to live/alive/living/work/workmanship/
或	或	huo4	/maybe/perhaps/might/possibly/or/
及	及	ji2	/to reach/and/
計	计	ji4	/to calculate/to compute/to count/reckon/ruse/to plan/
記	记	ji4	/to remember/to note/mark/sign/to record/
件	件	jian4	/(a measure word for thing/clothes/item/
建	建	jian4	/to establish/to found/to set up/to build/to construct/
交	交	jiao1	/to deliver/to turn over/to make friends/to intersect (lines)/to pay (money)/
叫	叫	jiao4	/to (be) call(ed)/
接	接	jie1	/to extend/to connect/to receive/to join/
解	解	jie3	/to separate/to divide/to break up/to loosen/to explain/to untie/to emancipate/
界	界	jie4	/circles (i.e. a group of people)/boundary/
今	今	jin1	/today/modern/present/current/this/now/
金	金	jin1	/metal/money/gold/
京	京	jing1	/capital/
九	九	jiu3	/nine/9/
覺	觉	jue2	/feel/find that/thinking/awake/aware/
利	利	li4	/advantage/benefit/profit/sharp/
立	立	li4	/set up/to stand/
林	林	lin2	/woods/forest/
路	路	lu4	/(surname)/road/path/way/
馬	马	ma3	/21st of month (tele.)/horse/Ma (a surname)/
毛	毛	mao2	/hair/pore/fur/
命	命	ming4	/life/fate/
目	目	mu4	/eye/item/
南	南	nan2	/south/
難	难	nan2	/difficult (to...)/problem/difficulty/difficult/not good/
期	期	qi1	/a period of time/phase/stage/(used for issue of a periodical, courses of study)/time/term/period/to hope/
親	亲	qin1	/dear/intimate/parent/relation/closely related/
清	清	qing1	/clear/distinct/complete/pure/
請	请	qing3	/to ask/to invite/please (do sth)/to treat (to a meal, etc)/to request/
讓	让	rang4	/to ask/to let/permit/have (someone do something)/to yield/to allow/
任	任	ren4	/to assign/to appoint/office/responsibility/
色	色	se4	/color/look/appearance/
神	神	shen2	/God/unusual/mysterious/soul/spirit/divine essence/lively/spiritual being/
師	师	shi1	/a division (milit.)/teacher/master/expert/model/
受	受	shou4	/to bear/to stand/to endure/(passive marker)/to receive/
書	书	shu1	/book/letter/
數	数	shu4	/number/figure/to count/to calculate/several/
司	司	si1	/company/control/
死	死	si3	/to die/inpassable/uncrossable/inflexible/rigid/
它	它	ta1	/it/
台	台	tai2	/your/
特	特	te2	/special/unusual/extraordinary/
提	提	ti2	/to carry/to lift/to put forward/(upwards character stroke)/lifting (brush stroke in painting)/to mention/
題	题	ti2	/topic/subject/to inscribe/to superscribe/
體	体	ti3	/body/form/style/system/
通	通	tong1	/go through/know well/to connect/to communicate/open/
統	统	tong3	/to gather/to unite/to unify/whole/
王	王	wang2	/king/Wang (proper name)/
望	望	wang4	/hope/expect/to visit/to gaze (into the distance)/look towards/towards/
務	务	wu4	/affair/business/matter/
物	物	wu4	/thing/object/matter/
係	系	xi4	/be/connection/relation/tie up/bind/
象	象	xiang4	/shape/form/appearance/to be like/to resemble/to take after/to seem/elephant/
笑	笑	xiao4	/laugh/smile/
性	性	xing4	/sex/nature/surname/suffix corresponding to -ness or -ity/
許	许	xu3	/to allow/to permit/to praise/(surname)/
眼	眼	yan3	/eye/
應	应	ying1	/ought/
原	原	yuan2	/former/original/primary/raw/level/cause/source/
員	员	yuan2	/person/employee/member/
戰	战	zhan4	/to fight/fight/war/battle/
張	张	zhang1	/(a measure word)/(a surname)/open up/
直	直	zhi2	/straight/vertical/frank/directly/straightly/upright/
至	至	zhi4	/arrive/most/to/until/
製	制	zhi4	/manufacture/
住	住	zhu4	/to live/to dwell/to reside/to stop/
字	字	zi4	/letter/symbol/character/word/
總	总	zong3	/always/to assemble/gather/total/overall/head/chief/general/in every case/
做	做	zuo4	/to do/to make/to produce/
