百	百	bai3	/hundred/
半	半	ban4	/half/semi-/incomplete/(after a number) and a half/half/
辦	办	ban4	/to do/to manage/to handle/to go about/to run/to set up/to deal with/
保	保	bao3	/to defend/to protect/to insure or guarantee/to maintain/hold or keep/to guard/
必	必	bi4	/certainly/must/will/necessarily/
變	变	bian4	/to change/to become different/to transform/to vary/rebellion/
步	步	bu4	/a step/a pace/walk/march/stages in a process/
城	城	cheng2	/city walls/city/town/
程	程	cheng2	/rule/order/regulations/formula/journey/procedure/sequence/a surname/
吃	吃	chi1	/eat/eradicate/destroy/receive/
持	持	chi2	/to grasp/to hold/support/manage/direct/maintain/
傳	传	chuan2	/to pass on/to spread/to transmit/to infect/to transfer/to circulate/to pass on/to conduct (electricity)/
達	达	da2	/attain/pass through/achieve/reach/realize/clear/inform/notify/dignity/
帶	带	dai4	/band/belt/girdle/ribbon/area/zone/region/wear/carry/lead/bring/consists of/show/and/
黨	党	dang3	/party/association/club/society/
倒	倒	dao3	/to fall/to collapse/to topple/to change/to fail/bankrupt/
德	德	de2	/Germany/virtue/goodness/morality/ethics/kindness/favor/character/kind/
隊	队	dui4	/squadron/team/group/
非	非	fei1	/non-/not-/un-/
夫	夫	fu1	/husband/man/
父	父	fu4	/father/
該	该	gai1	/that/the above-mentioned/most likely/to deserve/should/ought to/owe/
告	告	gao4	/to tell/to inform/to say/
革	革	ge2	/leather/remove/
跟	跟	gen1	/to follow/to go with/heel/with/and/
功	功	gong1	/merit/achievement/result/service/accomplishment/
管	管	guan3	/to take care (of)/to control/to manage/to be in charge of/to look after/to run/tube/pipe/
紅	红	hong2	/bonus/popular/red/revolutionary/
候	候	hou4	/wait/
花	花	hua1	/flower/blossom/to spend (money, time)/fancy pattern/
黃	黄	huang2	/(surname)/sulfur/yellow/
基	基	ji1	/base/foundation/basic/radical (chem.)/
即	即	ji2	/namely/right away/to approach/to draw near/
極	极	ji2	/extremely/pole (geog./physics)/utmost/top/
技	技	ji4	/skill/
江	江	jiang1	/river/
結	结	jie1	/knot/sturdy/to bear (fruit)/bond/to tie/to bind/
近	近	jin4	/near/close (to)/approximately/
決	决	jue2	/breach (a dyke)/to decide/to determine/
科	科	ke1	/branch of medicine/subject/division/field/branch/family/
空	空	kong4	/emptied/leisure/
快	快	kuai4	/fast/quick/swift/
李	李	li3	/(a surname)/plum/
聯	联	lian2	/to ally/to unite/to join/
連	连	lian2	/(surname)/even/as/join/to link/successively/
臉	脸	lian3	/face/
量	量	liang4	/capacity/quantity/amount/to estimate/
領	领	ling3	/neck/collar/to lead/to receive/
令	令	ling4	/make or cause to be/order/command/decree/honorable/
流	流	liu2	/to flow/to spread/to circulate/to move/
留	留	liu2	/leave (message)/to retain/to stay/to remain/to keep/to preserve/
六	六	liu4	/six/
論	论	lun4	/by the/per/discuss/theory/to talk (about)/to discuss/
滿	满	man3	/Manchurian/to fill/to fulfill/filled/packed/
每	每	mei3	/each/every/
呢	呢	ne5	/(question particle)/
派	派	pai4	/clique/school/group/faction/to dispatch/
品	品	pin3	/conduct/grade/thing/product/good/
七	七	qi1	/seven/7/
錢	钱	qian2	/(surname)/coin/money/
強	强	qiang2	/strength/force/power/powerful/better/
輕	轻	qing1	/hydrogen/light/easy/gentle/soft/
青	青	qing1	/9th of month (tele.)/blue-green/
求	求	qiu2	/to seek/to look for/to request/to demand/to beseech/
區	区	qu1	/(ancient volume measure)/(surname)/area/region/district/small/distinguish/
權	权	quan2	/authority/power/right/
認	认	ren4	/to recognize/to know/to admit/
社	社	she4	/society/group/
深	深	shen1	/deep/profound/
甚	甚	shen4	/very/
識	识	shi2	/to know/knowledge/
士	士	shi4	/scholar/warrior/knight/
式	式	shi4	/type/form/pattern/style/
收	收	shou1	/to receive/to accept/to collect/
朮	术	shu4	/method/technique/
思	思	si1	/to think/to consider/
算	算	suan4	/regard as/to figure/to calculate/to compute/
條	条	tiao2	/measure word for long, thin things (i.e. ribbon, river, etc.)/a strip/item/article/
完	完	wan2	/to finish/to be over/whole/complete/entire/
往	往	wang3	/to go (in a direction)/past/previous/towards/
未	未	wei4	/1-3 p.m./8th earthly branch/not yet/did not/have not/not/
武	武	wu3	/martial/military/
息	息	xi1	/news/interest/breath/rest/
寫	写	xie3	/to write/
言	言	yan2	/to speak/to say/talk/word/
義	义	yi4	/justice/righteousness/meaning/
英	英	ying1	/(surname)/English/brave/
語	语	yu3	/dialect/language/speech/
元	元	yuan2	/(dynasty)/dollar/primary/first/
遠	远	yuan3	/far/distant/remote/
院	院	yuan4	/courtyard/institution/
運	运	yun4	/to move/to transport/to use/to apply/fortune/luck/fate/
怎	怎	zen3	/how/
展	展	zhan3	/to use/to spread out/to postpone/to unfold/
指	指	zhi3	/finger/to point/to direct/to indicate/
治	治	zhi4	/to rule/to govern/to manage/to control/to harness (a river)/cure/treatment/to heal/
眾	众	zhong4	/multitude/
週	周	zhou1	/cycle/week/
轉	转	zhuan3	/to convey/to forward (mail)/to transfer/to turn/to shift/
資	资	zi1	/resources/capital/to provide/to supply/to support/money/expense/
