本	本	ben3	/roots or stems of plants/origin/source/this/the current/root/foundation/basis/(a measure word)/
不	不	bu4	/(negative prefix)/not/no/
長	长	chang2	/length/long/forever/always/constantly/
成	成	cheng2	/finish/complete/accomplish/become/turn into/win/succeed/one tenth/
出	出	chu1	/to go out/to come out/to occur/to produce/to go beyond/to rise/to put forth/to occur/to happen/(a measure word for dramas, plays, or operas)/
從	从	cong2	/from/obey/observe/follow/
大	大	da4	/big/huge/large/major/great/wide/deep/oldest/eldest/
當	当	dang1	/to be/to act as/manage/withstand/when/during/ought/should/match equally/equal/same/obstruct/just at (a time or place)/on the spot/right/just at/
到	到	dao4	/to (a place)/until (a time)/up to/to go/to arrive/
道	道	dao4	/direction/way/method/road/path/principle/truth/reason/skill/method/Tao (of Taoism)/a measure word/to say/to speak/to talk/
得	得	de2	/obtain/get/gain/proper/suitable/proud/contented/allow/permit/ready/finished/
的	的	de5	/(possessive particle)/of/
地	地	di4	/earth/ground/field/place/land/
動	动	dong4	/to use/to act/to move/to change/
都	都	dou1	/all/both (if two things are involved)/entirely (due to)each/even/already/
對	对	dui4	/couple/pair/to be opposite/to oppose/to face/for/to/correct (answer)/to answer/to reply/to direct (towards sth)/right/
多	多	duo1	/many/much/a lot of/numerous/multi-/
而	而	er2	/and/as well as/but (not)/yet (not)/(shows causal relation)/(shows change of state)/(shows contrast)/
發	发	fa1	/to send out/to show (one's feeling)/to issue/to develop/
方	方	fang1	/square/quadrilateral/direction/just/
個	个	ge4	/(a measure word)/individual/
公	公	gong1	/just/honorable (designation)/public/common/
國	国	guo2	/country/state/nation/
過	过	guo4	/(past tense marker)/to cross/to go over/to pass (time)/to live/to get along/(surname)/
還	还	hai2	/also/in addition/more/still/else/still/yet/(not) yet/
好	好	hao3	/good/well/
和	和	he2	/and/together with/with/peace/harmony/union/
后	后	hou4	/queen/
會	会	hui4	/can/be possible/be able to/to assemble/to meet/to gather/to see/union/group/association/
家	家	jia1	/-ist/-er/-ian/home/family/a person engaged in a certain art or profession/
見	见	jian4	/to see/to meet/to appear (to be sth)/to interview/
經	经	jing1	/classics/sacred book/pass through/to undergo/scripture/
就	就	jiu4	/at once/then/right away/only/(emphasis)/to approach/to move towards/to undertake/
開	开	kai1	/open/operate (vehicle)/start/
看	看	kan1	/to look after/to take care of/to watch/to guard/
可	可	ke3	/can/may/able to/certain(ly)/to suit/(particle used for emphasis)/
來	来	lai2	/to come/
老	老	lao3	/(a prefix used before the surname of a person or a numeral indicating the order of birth of the children in a family to indicate affection or familiarity)/old (of people)/
了	了	le5	/(modal particle intensifying preceding clause)/(past tense marker)/
裡	里	li3	/2 kilometer/village/within/inside/
兩	两	liang3	/both/two/ounce/some/a few/tael/
么	么	me5	/(interrog. suff.)/
沒	没	mei2	/(negative prefix for verbs)/have not/not/
們	们	men5	/(plural marker for pronouns and a few animate nouns)/
面	面	mian4	/fade/side/surface/aspect/top/face/flour/noodles/
那	那	na4	/that/those/
能	能	neng2	/can/may/capable/energy/able/
你	你	ni3	/you/
年	年	nian2	/year/
起	起	qi3	/to rise/to raise/to get up/
前	前	qian2	/before/in front/ago/former/previous/earlier/front/
去	去	qu4	/to go/to leave/to remove/
然	然	ran2	/correct/right/so/thus/like this/-ly/
人	人	ren2	/man/person/people/
日	日	ri4	/Japan/day/sun/date/day of the month/
如	如	ru2	/as (if)/such as/
三	三	san1	/three/
上	上	shang4	/on/on top/upon/first (of two parts)/previous or last (week, etc.)/upper/higher/above/previous/to climb/to go into/above/to go up/
生	生	sheng1	/to be born/to give birth/life/to grow/
十	十	shi2	/ten/
時	时	shi2	/O'clock/time/when/hour/season/period/
事	事	shi4	/matter/thing/item/work/affair/
是	是	shi4	/is/are/am/yes/to be/
手	手	shou3	/hand/convenient/
說	说	shuo1	/to speak/to say/
所	所	suo3	/actually/place/
他	他	ta1	/he/him/
她	她	ta1	/she/
天	天	tian1	/day/sky/heaven/
同	同	tong2	/like/same/similar/together/alike/with/
頭	头	tou2	/head/
為	为	wei2	/act as/take...to be/to be/to do/to serve as/to become/
文	文	wen2	/language/culture/writing/formal/literary/
我	我	wo3	/I/ me/ myself/
無	无	wu2	/-less/not to have/no/none/not/to lack/un-/
下	下	xia4	/under/second (of two parts)/next (week, etc.)/lower/below/underneath/down(wards)/to decline/to go down/latter/
想	想	xiang3	/to think/to believe/to suppose/to wish/to want/to miss/
小	小	xiao3	/small/tiny/few/young/
心	心	xin1	/heart/mind/
行	行	xing2	/all right/capable/competent/OK/okay/to go/to do/to travel/temporary/to walk/to go/will do/
學	学	xue2	/learn/study/science/-ology/
要	要	yao1	/demand/ask/request/coerce/
也	也	ye3	/also/too/
一	一	yi1	/one/single/a(n)/
以	以	yi3	/to use/according to/so as to/in order to/by/with/because/abbr. for Israel/
已	已	yi3	/already/to stop/then/afterwards/
用	用	yong4	/to use/
有	有	you3	/to have/there is/there are/to exist/to be/
又	又	you4	/(once) again/also/both... and.../again/
於	于	yu2	/at/in/in regard to/
在	在	zai4	/(located) at/in/exist/
這	这	zhe4	/this/these/
著	着	zhe5	/-ing (indicates an action in progress)/
之	之	zhi1	/(subor. part.)/him/her/it/
只	只	zhi3	/only/merely/just/but/
中	中	zhong1	/within/among/in/middle/center/while (doing sth)/during/China/Chinese/
主	主	zhu3	/to own/to host/master/lord/primary/
自	自	zi4	/from/self/oneself/since/
子	子	zi5	/(noun suff.)/
作	作	zuo4	/to regard as/to take (somebody) for/to do/to make/
