版	版	ban3	/a register/a block of printing/an edition/version/page/
包	包	bao1	/to cover/to wrap/to hold/to include/to take charge of/package/wrapper/container/bag/to hold or embrace/bundle/packet/to contract (to or for)/
寶	宝	bao3	/a jewel or gem/a treasure/precious/
編	编	bian1	/weave/plait/organize/group/arrange/edit/compile/write/compose/fabricate/
兵	兵	bing1	/soldiers/a force/an army/weapons/arms/military/warlike/
布	布	bu4	/to declare/to announce/to spread/to make known/spread/(cotton) cloth/
曾	曾	ceng2	/(refers to something that happened previously)/already/at some time in the past/before/once/
沖	冲	chong1	/to rinse/to collide/to water/to rush/to dash (against)/to wash out/to charge/highway/public road/
單	单	dan1	/bill/list/form/single/only/sole/
導	导	dao3	/to transmit/to lead/to guide/to conduct/to direct/
弟	弟	di4	/younger brother/
調	调	diao4	/mode (music)/to move (troops)/tune/tone/melody/to transfer/
讀	读	du2	/to read/to study/
段	段	duan4	/(surname)/paragraph/section/segment/
房	房	fang2	/house/
飛	飞	fei1	/to fly/
府	府	fu3	/prefecture/mansion/
改	改	gai3	/to change/to alter/to transform/to correct/
格	格	ge2	/frame/rule/
根	根	gen1	/radical (chem.)/root/basis/
官	官	guan1	/official/government/
觀	观	guan1	/to look at/to watch/to observe/to behold/
廣	广	guang3	/wide/numerous/to spread/
孩	孩	hai2	/child/
黑	黑	hei1	/black/dark/
乎	乎	hu1	/(interrog. part.)/
火	火	huo3	/fire/
級	级	ji2	/level/grade/rank/step/
集	集	ji2	/to gather/to collect/collected works/
濟	济	ji4	/aid/ferry/frugal/
際	际	ji4	/border/edge/boundary/between/among/interval/while/
劍	剑	jian4	/(double-edged) sword/
講	讲	jiang3	/to talk/speech/to speak/to tell/to explain/
盡	尽	jin4	/to use up/to exhaust/to end/to finish/to the utmost/exhausted/finished/to the limit (of sth)/
精	精	jing1	/energy/perfect/excellent/refined/very/proficient/
竟	竟	jing4	/unexpectedly/actually/to go so far as to/indeed/
究	究	jiu1	/after all/to investigate/to study carefully/
局	局	ju2	/(a measure word used for games) set or round office/situation/office/
据	据	ju4	/act in accordance with/seize/
克	克	ke4	/gram/subdue/to restrain/to overcome/
拉	拉	la1	/to pull/to play (string instruments)/to drag/to draw/
離	离	li2	/to leave/to depart/to go away/from/
曆	历	li4	/calendar/
落	落	luo4	/alight/to fall/to drop (behind)/
母	母	mu3	/female/mother/
拿	拿	na2	/to hold/to seize/to catch/to apprehend/to take/
哪	哪	na3	/how/which/
怕	怕	pa4	/to be afraid/to fear/
片	片	pian4	/a slice/piece/flake/thin/slice/
千	千	qian1	/thousand/
切	切	qie1	/to cut/to slice/
且	且	qie3	/further/moreover/
取	取	qu3	/to take/to get/to choose/to fetch/
容	容	rong2	/to hold/to contain/to allow/appearance/look/countenance/
若	若	ruo4	/to seem/like/as/if/
殺	杀	sha1	/to kill/to murder/to slaughter/
商	商	shang1	/commerce/consult/
設	设	she4	/to set up/to arrange/to establish/to found/to display/
誰	谁	shei2	/who/
失	失	shi1	/to lose/to miss/to fail/
石	石	shi2	/rock/stone/
史	史	shi3	/history/
始	始	shi3	/begin/
示	示	shi4	/to show/reveal/
視	视	shi4	/to look at/to regard/to inspect/
首	首	shou3	/head/chief/(a measure word, use with "poem")/
雙	双	shuang1	/two/double/pair/both/
斯	斯	si1	/(phonetic)/this/
似	似	si4	/to seem/to appear/similar/like/to resemble/
雖	虽	sui1	/although/even though/
隨	随	sui2	/to follow/to comply with/to allow/(surname)/
談	谈	tan2	/to speak/to talk/to converse/to chat/to discuss/(surname)/
團	团	tuan2	/regiment/round/circular/group/society/
網	网	wang3	/net/network/
微	微	wei1	/micro/tiny/miniature/
委	委	wei3	/give up/indeed/to commission/
喜	喜	xi3	/to be fond of/to like/to enjoy/to be happy/to feel pleased/happiness/delight/glad/
香	香	xiang1	/fragrant/incense/(of food) savory/appetizing/sweet/scented/popular/
像	像	xiang4	/(look) like/similar (to)/look/appearance/elephant/to look/to appear/to seem/image/portrait/resemble/seem/
校	校	xiao4	/school/
形	形	xing2	/to appear/to look/form/shape/
研	研	yan2	/grind fine/study/research/
議	议	yi4	/criticize/discuss/
音	音	yin1	/sound/noise/news/
影	影	ying3	/picture/image/reflection/shadow/
友	友	you3	/friend/
樂	乐	yue4	/(surname)/music/
越	越	yue4	/to exceed/to climb over/to surpass/the more ... the more/
早	早	zao3	/early/morning/
造	造	zao4	/to make/to build/to invent/to manufacture/
則	则	ze2	/(expresses contrast with a previous sentence or clause)/standard/norm/rule/to imitate/to follow/then/principle/
站	站	zhan4	/station/to stand/to halt/to stop/
找	找	zhao3	/to try to find/to look for/to call on (sb)/to find/to seek/to return/to look for/
爭	争	zheng1	/struggle/fight/
志	志	zhi4	/the will/
終	终	zhong1	/end/finish/
專	专	zhuan1	/for a particular person, occasion, purpose/focused on one thing/special/expert/particular (to sth)/concentrated/specialized/
准	准	zhun3	/to allow/to grant/to permit/accurate/standard/
組	组	zu3	/to form/compose/make up/group/to organize/cord/
坐	坐	zuo4	/to sit/to take a seat/to take (a bus, airplane etc.)/
