把	把	ba3	/(a measure word)/(marker for direct-object)/to hold/to contain/to grasp/to take hold of/
北	北	bei3	/north/
被	被	bei4	/by (marker for passive-voice sentences or clauses)/quilt/blanket/to cover/to wear/
便	便	bian4	/ordinary/plain/convenient/handy/easy/then/so/thus/to relieve oneself/
併	并	bing4	/amalgamate/combine/
產	产	chan3	/to reproduce/to produce/give birth/products/produce/resources/estate/property/
此	此	ci3	/this/these/
次	次	ci4	/nth/number (of times)/order/sequence/next/second(ary)/(measure word)/
打	打	da3	/beat/strike/break/mix up/build/fight/fetch/make/tie up/issue/shoot/calculate/since/from/
代	代	dai4	/substitute/replace/generation/dynasty/geological era/era/age/period/
但	但	dan4	/but/yet/however/only/merely/still/
等	等	deng3	/class/rank/grade/equal to/same as/wait for/await/et cetera/and so on/
第	第	di4	/(prefix before a number, for ordering numbers, e.g. "first", "number two", etc)/
點	点	dian3	/(downwards-right convex character stroke)/o'clock/(a measure word)/point/dot/(decimal) point)/
電	电	dian4	/electric/electricity/electrical/
定	定	ding4	/to set/to fix/to determine/to decide/to order/
東	东	dong1	/east/
兒	儿	er2	/son/
二	二	er4	/two/
法	法	fa3	/law/method/way/Buddhist teaching/Legalist/
分	分	fen1	/to divide/minute/(a measure word)/
高	高	gao1	/high/tall/
給	给	gei3	/to/for/for the benefit of/to give/to allow/to do sth (for sb)/(passive particle)/
工	工	gong1	/work/worker/skill/profession/trade/craft/labor/
關	关	guan1	/(surname)/mountain pass/to close/to shut/to turn off/to concern/to involve/
海	海	hai3	/ocean/sea/
很	很	hen3	/very/extremely/
化	化	hua4	/to make into/to change into/-ization/to ... -ize/to transform/
話	话	hua4	/dialect/language/spoken words/speech/talk/words/conversation/what someone said/
几	几	ji1	/small table/
机	机	ji1	/machine/opportunity/secret/
己	己	ji3	/6th heavenly stem/self/
加	加	jia1	/to add/plus/
間	间	jian1	/between/among/space/(measure word)/
將	将	jiang1	/(will, shall, "future tense")/ready/prepared/to get/to use/
教	教	jiao1	/teach/
進	进	jin4	/advance/enter/to come in/
軍	军	jun1	/army/military/arms/
開	开	kai1	/open/operate (vehicle)/start/
口	口	kou3	/mouth/(a measure word)/
理	理	li3	/reason/logic/science/inner principle or structure/
力	力	li4	/power/force/strength/
美	美	mei3	/America/beautiful/
門	门	men2	/door/gate/field of endeavor/
民	民	min2	/the people/nationality/citizen/
名	名	ming2	/name/(measure word for persons)/place (e.g. among winners)/
明	明	ming2	/clear/bright/to understand/next/
內	内	nei4	/inside/inner/internal/within/interior/
女	女	nu:3	/female/woman/
平	平	ping2	/flat/level/equal/to make the same score/to tie/to draw/calm/peaceful/
其	其	qi2	/his/her/its/theirs/that/such/it (refers to sth preceding it)/
气	气	qi4	/air/anger/gas/
情	情	qing2	/feeling/emotion/passion/situation/
全	全	quan2	/all/whole/entire/every/complete/
卻	却	que4	/but/yet/however/while/to go back/to decline/to retreat/nevertheless/
入	入	ru4	/to enter/
山	山	shan1	/mountain/hill/
少	少	shao3	/few/little/lack/
身	身	shen1	/body/torso/person/life/status/pregnancy/(a measure word used for clothes) suit/
聲	声	sheng1	/sound/voice/(a measure word, used for sounds)/tone/noise/
什	什	shi2	/tenth/
實	实	shi2	/real/true/honest/really/solid/
使	使	shi3	/to make/to cause/to enable/to use/to employ/messenger/
世	世	shi4	/life/age/generation/era/world/lifetime/
市	市	shi4	/market/city/
手	手	shou3	/hand/convenient/
水	水	shui3	/water/river/
四	四	si4	/four/
太	太	tai4	/highest/greatest/too (much)/very/extremely/
聽	听	ting1	/listen/hear/obey/
外	外	wai4	/outside/in addition/foreign/external/
万	万	wan4	/(surname)/10,000/
位	位	wei4	/position/location/(measure word for persons)/place/seat/
問	问	wen4	/to ask/
無	无	wu2	/-less/not to have/no/none/not/to lack/un-/
五	五	wu3	/five/5/
西	西	xi1	/west/
先	先	xian1	/early/prior/former/in advance/first/
現	现	xian4	/appear/present/now/existing/current/
相	相	xiang1	/each other/one another/mutually/
向	向	xiang4	/direction/part/side/towards/to/guide/opposite to/
些	些	xie1	/some/few/several/(a measure word)/
新	新	xin1	/meso- (chem.)/new/newly/
信	信	xin4	/letter/true/to believe/sign/evidence/
樣	样	yang4	/manner/pattern/way/appearance/shape/
意	意	yi4	/idea/meaning/wish/desire/
因	因	yin1	/cause/reason/because/
由	由	you2	/follow/from/it is for...to/reason/cause/because of/due to/by/to/to leave it (to sb)/
與	与	yu3	/and/to give/together with/
月	月	yue4	/moon/month/
再	再	zai4	/again/once more/re-/second/another/
者	者	zhe3	/-ist, -er (person)/person (who does sth)/
真	真	zhen1	/real/true/genuine/
政	政	zheng4	/politics/
正	正	zheng4	/just (right)/main/upright/straight/correct/principle/
知	知	zhi1	/to know/to be aware/
種	种	zhong3	/kind/type/race (of people)/seed/type/
重	重	zhong4	/heavy/serious/
走	走	zou3	/to walk/to go/to move/
最	最	zui4	/(the) most/-est/
