家	家	jia1	/-ist; -er; -ian; home; family; a person engaged in a certain art or profession/
客人	客人	ke5en5	/guest/
請	请	qing3	/to ask; to invite; please (do sth); to treat (to a meal, etc); to request/
李	李	li3	/(a surname); plum/
口	口	kou3	/mouth; (a measure word)/
跟	跟	gen1	/to follow; to go with; heel; with; and/
同學	同学	tong2xue2	/(fellow) classmate/
的	的	de5	/(possessive particle); of/
買	买	mai3	/buy/
只	只	zhi1	/(a measure word, for birds and some animals, etc.); single; only/
雞	鸡	ji1	/fowl; chicken/
條	条	tiao2	/measure word for long, thin things (i.e. ribbon, river, etc.); a strip; item; article/
魚	鱼	yu2	/fish/
青菜	青菜	qing1cai4	/green vegetables; Chinese cabbage/
還	还	hai2	/also; in addition; more; still; else; still; yet; (not) yet/
湯	汤	tang1	/(surname); soup/
瓶	瓶	ping2	/bottle; (a measure word); vase; pitcher/
钱	钱	qian2	/(surname); coin; money/
夠	够	gou4	/to reach; to be enough/
肯	肯	ken3	/to agree; to consent; to be ready (to do sth); willing/
行	行	xing2	/all right; capable; competent; OK; okay; to go; to do; to travel; temporary; to walk; to go; will do/
半	半	ban4	/half; semi-; incomplete; (after a number) and a half; half/
可以	可以	ke3yi3	/can; may; possible; able to/
准	准	zhun3	/to allow; to grant; to permit; accurate; standard/
怎么樣	怎么样	zen3me5yang4	/how?; how about?; how was it?; how are things?/
貴	贵	gui4	/expensive; noble; your (name); precious/
那么	那么	na4 me5	/in that case/
抽	抽	chou1	/to draw out; to smoke (cigarettes); to pump/
煙	烟	yan1	/cigarette; tobacco; smoke/
抽煙	抽烟	chou1yan1	/smoke (a cigarette)/
支	支	zhi1	/(a measure word for pens, cigarettes, etc.)/
包	包	bao1	/to cover; to wrap; to hold; to include; to take charge of; package; wrapper; container; bag; to hold or embrace; bundle; packet; to contract (to or for)/
對不起	对不起	dui4bu5qi3	/I'm sorry; pardon me; forgive me/
字	字	zi4	/letter; symbol; character; word/
對	对	dui4	/correct (answer)/right/
先	先	xian1	/early; prior; former; in advance; first/
筆	笔	bi3	/pen; pencil; writing brush; to write or compose; the strokes of Chinese characters/
用	用	yong4	/to use/
份	份	fen4	/(a measure word for gifts, copies of a newspaper); copy (of newspaper, magazine, etc.); share; portion; part; (a measure word)/
報	报	bao4	/to announce; to inform; report; newspaper; recompense; revenge/
