報	报	bao4	/to announce/to inform/report/newspaper/recompense/revenge/
杯	杯	bei1	/cup/a measure word/
本	本	ben3	/roots or stems of plants/origin/source/this/the current/root/foundation/basis/(a measure word for books and notebooks)/
本子	本子	ben3zi	/book/notebook/edition/
筆	笔	bi3	/pen/pencil/writing brush/to write or compose/the strokes of Chinese characters/
場	场	chang3	/a courtyard/open space/place/field/a measure word/(a measure word, used for sport or recreation)/
東西	东西	dong1xi	/thing/person/
份	份	fen4	/(a measure word for gifts, copies of a newspaper)/copy (of newspaper, magazine, etc.)/share/portion/part/
戈	戈	ge1	/(surname)/spear/
給	给	gei3	/to/for/for the benefit of/to give/to allow/to do sth (for sb)/(passive particle)/
跟	跟	gen1	/to follow/to go with/heel/with/and/
功夫	功夫	gong1fu	/skill/art/kung fu/labor/effort/
光	光	guang1	/light/ray/bright/
光槃	光盘	guang1pan2	/compact disc/
貴	贵	gui4	/expensive/noble/your (name)/precious/
蕉	蕉	jiao1	/banana/
角	角	jiao3	/(毛 mao)/angle/horn/horn-shaped/
斤	斤	jin1	/catty/weight equal to 0.5 kg/
金	金	jin1	/metal/money/gold/
烤鴨店	烤鸭店	kao3ya1 dian4	/roast duck restaurant/
塊	块	kuai4	/yuan (unit of currency)/fast (of a watch)/swift/rapid/happy/joyful/soon/quick/(a measure word, for cloth, cake, soap)/
梁祝	梁祝	Liang2Zhu4	/(name of a Chinese violin concerto)/
賣	卖	mai4	/to sell/
毛	毛	mao2	/hair/pore/fur/
皿	皿	min3	/dish/household utensils/
盤	盘	pan2	/dish/tray/to build/to check/to examine/to transfer/(a measure word used for dishes of food or coils of wire)/to coil/
便宜	便宜	pian2yi	/inexpensive/
蘋	苹	ping2	/apple/
蘋果	苹果	ping2guo3	/apple/
钱	钱	qian2	/(surname)/coin/money/
容	容	rong2	/to hold/to contain/to allow/appearance/look/countenance/
容易	容易	rong2yi4	/easy/likely/liable (to)/
商	商	shang1	/commerce/consult/
商場	商场	shang1chang3	/market/bazaar/
師	师	shi1	/a division (milit.)/teacher/master/expert/model/
師傅	师傅	shi1fu	/master/a qualified worker/
售貨員	售货员	shou4huo4yuan2	/salesperson/
書	书	shu1	/book/letter/
書店	书店	shu1dian4	/bookstore/
送	送	song4	/to deliver/to carry/to give (as a present)/to present (with)/to see off/to send/
體育館	体育馆	ti3yu4guan3	/gym/gymnasium/stadium/
勿	勿	wu4	/do not/
香	香	xiang1	/fragrant/incense/(of food) savory/appetizing/sweet/scented/popular/
香蕉	香蕉	xiang1jiao1	/banana/
香蕉蘋果	香蕉苹果	xiang1jiao1ping2guo3	/apple with a banana taste/
穴	穴	xue2	/hole/cave/
有名	有名	you3ming2	/famous/well-known/
樂	乐	yue4	/(surname)/music/(or lè, happy, laugh, cheerful)/
怎麼	怎么	zen3me	/how?/what?/why?/
找	找	zhao3	/to try to find/to look for/to call on (sb)/to find/to seek/to return/to look for/zhao(qian) is to give change/
支	支	zhi1	/(a measure word for stick-like things such as pens)/to support/to sustain/to erect/to raise/branch/division/to draw money/
舟	舟	zhou1	/boat/
走	走	zou3	/to walk/to go/to move/
足	足	zu2	/foot/to be sufficient/
作家	作家	zuo4jia1	/author/writer/
售货	售货	shou4 huo4	/to sell goods/
傅	傅	fu4	/(surname); tutor/
東	东	dong1	/east/
體育	体育	ti3 yu4	/physical culture; physical training; sports/
一遍	一遍	yi1bian4	/one time/once/
